1111111111111111111111
1E0000000000001C000001
1000000000000011101001
1000010000G01011001001
1P0001100C001111100001
1000C1111C00001100C001
1000C0111C000000000001
1000000C110000100000C1
1000000000001100000011
1111111C00000110000001
1110000000001110000001
111000000C01111000C001
1111111111111111111111
