111111111111111111111111111
1E000000000G000C000000000C1
101001010010000010100000011
101001001010101000100000011
1P0000000C00000000000000001
1000C0000C00000000C00000001
1000C0000C00000000000000001
1000000C000000100000C000001
100000000000011000000000001
1000000C0000011000000000001
100000000000111000000000001
100000000C01111000C00000001
111111111111111111111111111
