111111111
1C0P001E1
1100C1101
10C011101
1C0000001
1C0000001
1C0000001
1C0000001
1C0000001
111111111
