11111111111111111111111
1E000000000G000C00000C1
10100101001000001010011
10100100101010100010011
1P0000000C00C0000000001
11111111111111111111111
