111111111111111
1C0P001E0000001
1100C11000G1001
10C011100100001
1C0000000011111
100000000000001
1C0000000000001
1C0000000000001
1C0000000001111
1C0000000001111
111111111111111
111111111111111
111111111111111
111111111111111
